[
  {
    "//": "autodoc operating theatre",
    "type": "mapgen",
    "method": "json",
    "om_terrain": [ "lab_finale_1level" ],
    "weight": 25,
    "object": {
      "rotation": [ 0, 3 ],
      "fill_ter": "t_thconc_floor",
      "rows": [
        "........................",
        "........................",
        "........................",
        "........................",
        "........................",
        "........................",
        "........................",
        "........................",
        "........................",
        "...........|............",
        "..6.....................",
        ".........|.*.|..........",
        "........................",
        "...........|............",
        "........................",
        "........................",
        "........................",
        "........................",
        "........................",
        "........................",
        "........................",
        "........................",
        "........................",
        "........................"
      ],
      "palettes": [ "lab_palette", "lab_loot_research" ],
      "terrain": {
        "6": "t_console",
        "|": "t_wall_metal"
      },
      "computers": {
        "6": {
          "name": "Portal Control",
          "security": 0,
          "options": [ { "name": "", "action": "open", "security": 0 } ]
        },
      },
      "place_monster": [
        { "monster": "mon_hunting_horror", "x": [0, 21], "y": [0, 21], "repeat": 4 }
      ]
    }
  }
]